########..##....##..#######...##..##
..####.....##..##...##....##..##..##
...##........##.....#######...######
...##........##.....##........##..##
...##........##.....##........##..##