########################################
#......................................#
#.########..##....##..#######...##..##.#
#...####.....##..##...##....##..##..##.#
#....##........##.....#######...######.#
#....##........##.....##........##..##.#
#....##........##.....##........##..##.#
#......................................#
########################################