.....................................
.########..##....##..#######...##..##
...####.....##..##...##....##..##..##
....##........##.....#######...######
....##........##.....##........##..##
....##........##.....##........##..##
.....................................